Gene Symbol	Forward Primer	Reverse Primer
Hprt	GCAAACTTTGCTTTCCCTGGTT	CAAGGGCATATCCAACAACA
Top2b	AGCACAAGAGCGGGAAGATA	TGGGGTCAATGTCTCCTCTC
Crygc	TGCTGCCTCATCCCCCAACA	TCGCCTAAAAGAGCCAACTT
Usp12	GAGACGTGGACAACGAGGAT	AGGATCAGGGGCAGTTTCTT
Hspa1b	TTTCCAAACTGGATCGAAGG	GACACCATCACCTTGGGTTT
Ywhag	ATCCTCTTCAGCCCTGTGAA	TCGGACCATCTCGATCTTCT
Bfsp1	TCCCTGGTTACTGGGATGAG	TGCTGCCTTCAATCTCAATG
Kif5c	CGCTGATGTTTGGACAGAGA	GGGCTCTAGGCTCTTCTGGT
Aqp0	CGTGCTCTGCATCTTTGCTA	ACCCTCCCCACAGTCTCTTT
Cpeb4	TGCATTCCTGCTGTTTCAAG	AGCCGATCCATTATCATTGC
Rs1h	TCCTATGCCAGCTCTCCACT	TGTGATATGGGCATTCTGGA
Cryga	CTCCTGCCGTTCCATTCCAT	GTCGTGGTAGCGCCTGTAGT
Hba-a1	ATCCCGTCAACTTCAAGCTC	AGGTACAGGTGCAAGGGAGA
Nr4a1	GGCATGGTGAAGGAAGTTGT	TCTGCCCACTTTCGGATAAC
Egr2	CAGTTCAACCCCTCTCCAAA	CACTCCGTTCATCTGGTCAA
Hbb-b1	ATGGCCTGAATCACTTGGAC	GAGCAGGAAAGGGGGTTTAG
Fosb	TGTCTTCGGTGGACTCCTTC	TGGGGTTGAGTAGCTGGTTC
Tyrp1	CGTTGGAAAACGCACCTATT	TCAGTGAGGAGAGGCTGGTT
Alas2	CCGAAGCCATTCATTTCCTA	CCATAGATGCCTCGGAGAAG
Sfln4	GGCAAAACGCAGCAAATTAT	ATCACCTTTCCAGGCATCAC
S100a9	TCATCGACACCTTCCATCAA	TCAACTTTGCCATCAGCATC
Ifi202a	CAGCGTGTCTGAGGTGAAGA	CCACCACTTTCATTGCTCCT
Cfb	TCTGAGTCTCTGTGGCATGG	GATCCCTTCTGCCTTTTTCC
Isg12	TCCTCCATAGCAGCCAAGAT	TCTGACTTGAGTGGGGGTTT
Lcn2	ATGTCACCTCCATCCTGGTC	CACACTCACCACCCATTCAG
C3	TGTCACTCACAGCCTTCGTC	GGATGTGGCCTCTACGTTGT
Mmp3	CAGGTGTGGTGTTCCTGATG	CGTCAAAGTGAGCATCTCCA
Ifi44	AGTTCTGCTGCTGGGTCCTA	GTCAGGAGTGTGGCCCTTTA
Ifit1	CAAGGCAGGTTTCTGAGGAG	TGGATCAAGGCTTCAGCTTC
Chi3l1	ACCAACCTGAAGACCCTCCT	ATTCCGCATTCAGTTCCTTG
Trim30	GGAGAGAAACTCCGGCTCTT	TGCCTCCCAGTCAACTCTCT
Arg1	GTGAAGAACCCACGGTCTGT	CTGGTTGTCAGGGGAGTGTT
Tnfaip9	CTGGAGAGAGTTCCGGTTTG	ATCCGATTTTCCGTTCAGTG
Tgfbi	CTGTTTTTGCTCCCACCAAT	GGCAACAGGCTCCTTATTGA
Cd53	TGGGCTTTGGCATCTATTTC	AGCAGGATGGCTATGGTCAC
Lrg1	CTGGGGTCTTGAGGACAGAC	AATTCCACCGACAGATGGAC
Arr3	CTTCTCCCAGACCTTTGCAG	CTCCACACCAACATCACTGG
Col1a2	TGCTCAGCTTTGTGGATACG	AGGGCCAGATGAAACTCCTT
Spp1	ATTTGCTTTTGCCTGTTTGG	CTCCATCGTCATCATCATCG
Col3a1	TGGTCCTCAGGGTGTAAAGG	GTCCAGCATCACCTTTTGGT
Fbln2	GACGTGGACGAATGTGTGAC	GGTGTAGGAGCCCACTGTGT
Fn1	AATGGAAAAGGGGAATGGAC	CTCGGTTGTCCTTCTTGCTC
Bgn	GACAACCGTATCCGCAAAGT	GTGGTCCAGGTGAAGTTCGT
Lzp-s	TGGCTGACTGGGTGTGTTTA	CGGTTTTGACATTGTGTTCG
Cxcl4	CTTCTGGGCCTGTTGTTTCT	TTTTCCTCCCATTCTTCAGG
Prg1	GAACTGCATCGAGGAGAAGG	TGTTGGCTGGTATTCCCATT
Ecm1	ATAAAGACCCACCCCCACTC	AGCAGCGGATGGTCATATTC
Timp1	TCCCCAGAAATCAACGAGAC	CTCAGAGTACGCCAGGGAAC
Cd68	TTCTGCTGTGGAAATGCAAG	AGAGGGGCTGGTAGGTTGAT
