Gene	Forward	Reverse
ACTB	AAGATCAAGATCATTGCTCCTC	GGGTGTAACGCAACTAAGTC
BRI3	AGGGTCTACAACATCCACAG	TGTTCCCTTTAAGCGAAGGT
CABP1	CTTCAGAGAATTCGACAAGGAC	CATTGGTGTCAAACTCTCGG
CLU	GAATTGGAGGCATGATGAAGAC	CTGATTGGACATTTCCTGGAG
CPLX1	CTTGATGCCGTACTTGTCTC	GGAGTTTGTGATGAAGCAGG
GAPDH	TTAGCACCCCTGGCCAAGG	CTTACTCCTTGGAGGCCATG
HPCAL	AACAATGACGGCAAACTGTC	GACAAGCCTGTGTTTCTCTG
HSRRN18S	CTGAAACTTAAAGGAATTGACGGA	GTTATCGGAATTAACCAGACAAATC
IQSEC	GGCTGAAATTCCACATTGCT	TGGAGAAGCACAGGATAGAG
LOC157627	GTCTGGCTTAAATGAAAGGG	GACTCCATTCTTTGCCTCTG
C17ORF45	CAAATAAAGAGCTCGAGCTTCTG	GGAATATAACCTTCTCTTGGGC
NCDN	CACATCTCTAATGAACACCCT	GGACTGTGATAGGAAGAGGA
RIMS3	AGTTCAGCGATTTCCTGGAT	CTTGATATAGGTGGCTGGGAG
CNN3	GCTCATGCCTGTCACCTCTT	CTCGGCCGAAGTCAAGAA
CPLX1	GTCTGGGTCCTTCTCCTCGT	ATCGCCATGGAGTTTGTGAT
AXIN2	TTATGCTTTGCACTACGTCCCTCCA	CGCAACATGGTCAACCCTCAGAC
PHYHIP	TCTACCGCAACCATCACAAGG	CTGGCCCGTGTTGAACTCC
SOX8	CAAGGGCTACGACTGGAGTCT	CATGCGGCTTGGCTTTGAG
SNAP91	AGCCACAACTGTTACGTCTCC	TCTCCCAAAAGGTCTCCCCAT
