Gene symbol	Gene name	Fold change	Gene function
ACP5	Acid phosphatase 5, tartrate resistant	2.5	Extracellular matrix component/regulation/adhesion
ALPL	Alkaline phosphatase, liver/bone/kidney	2.1	Extracellular matrix component/regulation/adhesion
BGLAP	Bone gamma-Carboxyglutamate (gla) protein (osteocalcin)	15.1	Extracellular matrix component/regulation/adhesion
CDH11	Cadherin 11, type 2, OB-cadherin (osteoblast)	1.6	Extracellular matrix component/regulation/adhesion
CHAD	Chondroadherin	9.3	Extracellular matrix component/regulation/adhesion
CLEC3B	C-type lectin domain family 3, member B	1.6	Extracellular matrix component/regulation/adhesion
COL11A1	Collagen, type XI, alpha 1	4.2	Extracellular matrix component/regulation/adhesion
COL11A2	Collagen, type XI, alpha 2	4.4	Extracellular matrix component/regulation/adhesion
COL13A1	Collagen, type XIII, alpha 1	3.5	Extracellular matrix component/regulation/adhesion
COL5A2	Collagen, type V, alpha 2	1.8	Extracellular matrix component/regulation/adhesion
EXT2	Exostoses (multiple) 2	1.6	Extracellular matrix component/regulation/adhesion
EXTL1	Exostoses (multiple)-like 1	1.5	Extracellular matrix component/regulation/adhesion
IBSP	Integrin-binding sialoprotein	1.9	Extracellular matrix component/regulation/adhesion
MATN3	Matrilin 3	1.4	Extracellular matrix component/regulation/adhesion
MEPE	Matrix extracellular Phosphoglycoprotein	-3.6	Extracellular matrix component/regulation/adhesion
MMP2	Matrix metallopeptidase 2	2.2	Extracellular matrix component/regulation/adhesion
PCSK5	Proprotein convertase subtilisin/kexin type 5	2.1	Extracellular matrix component/regulation/adhesion
PHEX	Phosphate regulating endopeptidase homolog, X-linked	1.9	Extracellular matrix component/regulation/adhesion
PRELP	Proline/arginine-rich end leucine-rich repeat protein	1.2	Extracellular matrix component/regulation/adhesion
SPARC	Secreted protein, acidic, cysteine-rich (osteonectin)	2.1	Extracellular matrix component/regulation/adhesion
ARID5B	AT-rich interactive domain 5B (MRF1-like)	1.5	Transcription factor/transcription factor regulation
CHRDL2	Chordin-like 2	1.7	Transcription factor/transcription factor regulation
DLX1	Distal-less homeobox 1	1.6	Transcription factor/transcription factor regulation
DLX5	Distal-less homeobox 5	1.9	Transcription factor/transcription factor regulation
EIF2AK3	Eukaryotic translation initiation factor 2-alpha kinase 3	1.4	Transcription factor/transcription factor regulation
ETS2	v-ets erythroblastosis virus E26 oncogene homolog 2 (avian)	-1.2	Transcription factor/transcription factor regulation
EYA1	Eyes absent homolog 1 (Drosophila)	2	Transcription factor/transcription factor regulation
FOXC1	Forkhead box C1	1.7	Transcription factor/transcription factor regulation
GAS1	Growth arrest-specific 1	1.8	Transcription factor/transcription factor regulation
GLI2	GLI family zinc finger 2	1.4	Transcription factor/transcription factor regulation
HDAC4	Histone deacetylase 4	1.9	Transcription factor/transcription factor regulation
HOXD12	Homeobox D12	1.4	Transcription factor/transcription factor regulation
MEF2D	Myocyte enhancer factor 2D	1.4	Transcription factor/transcription factor regulation
MSX1	msh homeobox 1	2.4	Transcription factor/transcription factor regulation
OSR2	Odd-skipped related 2 (Drosophila)	1.4	Transcription factor/transcription factor regulation
PCGF2	Polycomb group ring finger 2	1.7	Transcription factor/transcription factor regulation
PRKCA	Protein kinase C, alpha	1.8	Transcription factor/transcription factor regulation
PRRX1	Paired related homeobox 1	1.2	Transcription factor/transcription factor regulation
PRRX2	Paired related homeobox 2	1.5	Transcription factor/transcription factor regulation
SATB2	SATB homeobox 2	2.5	Transcription factor/transcription factor regulation
SHOX2	short stature homeobox 2	1.5	Transcription factor/transcription factor regulation
SIX2	SIX homeobox 2	1.4	Transcription factor/transcription factor regulation
SIX4	SIX homeobox 4	2	Transcription factor/transcription factor regulation
SOX6	SRY (sex determining region Y)-box 6	1.1	Transcription factor/transcription factor regulation
SOX9	SRY (sex determining region Y)-box 9	2.3	Transcription factor/transcription factor regulation
SP1	Sp1 transcription factor	1.3	Transcription factor/transcription factor regulation
SP7	Sp7 transcription factor (Osterix)	2.7	Transcription factor/transcription factor regulation
SUFU	Suppressor of fused homolog (Drosophila)	1.3	Transcription factor/transcription factor regulation
TP63	Tumor protein p63	-1.4	Transcription factor/transcription factor regulation
TRAPPC2	Trafficking protein particle complex 2	1.6	Transcription factor/transcription factor regulation
TWIST1	Twist homolog 1 (Drosophila)	1.6	Transcription factor/transcription factor regulation
ATP6V1B1	ATPase, H þtransporting, lysosomal 56/58 kDa, V1 subunit B1	1.3	Receptor activity
CTSK	Cathepsin K	2.1	Receptor activity
ESRRA	Estrogen-related receptor alpha	-1.5	Receptor activity
GHR	Growth hormone receptor	2.1	Receptor activity
PTHR1	Parathyroid hormone 1 receptor	4.3	Receptor activity
SMO	Smoothened homolog (Drosophila)	1.4	Receptor activity
THRA	Thyroid hormone receptor, alpha	13.2	Receptor activity
IGF1	Insulin-like growth factor 1 (somatomedin C)	2.9	Growth factor activity/regulation
KAZALD1	Kazal-type serine peptidase inhibitor domain 1	3.5	Growth factor activity/regulation
KIAA1217	KIAA1217	2.6	Growth factor activity/regulation
PDGFRA	Platelet-derived growth factor receptor, alpha-polypeptide	2.4	Growth factor activity/regulation
PDLIM7	PDZ and LIM domain 7 (enigma)	-2	Growth factor activity/regulation
PRDX1	Peroxiredoxin 1	-1.4	Growth factor activity/regulation
PTN	Pleiotrophin	2	Growth factor activity/regulation
RYK	RYK receptor-like tyrosine kinase	1.4	Growth factor activity/regulation
TWSG1	Twisted gastrulation homolog 1 (Drosophila)	1.4	Growth factor activity/regulation
ACVR1	Activin A receptor, type I	1.6	TGF-beta/BMP signalling pathway
BAMBI	hypothetical LOC729590; BMP and activin membrane-bound inhibitor homolog (Xenopus laevis)	3.6	TGF-beta/BMP signalling pathway
BMP4	Bone morphogenetic protein 4	1.1	TGF-beta/BMP signalling pathway
BMPR1A	Bone morphogenetic protein receptor, type IA; similar to ALK-3	1.2	TGF-beta/BMP signalling pathway
CD36	CD36 molecule (thrombospondin receptor)	2.1	TGF-beta/BMP signalling pathway
CDKN2B	Cyclin-dependent kinase inhibitor 2B (p15, inhibits CDK4)	1.4	TGF-beta/BMP signalling pathway
FKBP1A	FK506-binding protein 1A, 12 kDa	-2.6	TGF-beta/BMP signalling pathway
FSTL1	Follistatin-like 1	2	TGF-beta/BMP signalling pathway
GDF10	growth differentiation factor 10	1.6	TGF-beta/BMP signalling pathway
ID4	Inhibitor of DNA binding 4	2.3	TGF-beta/BMP signalling pathway
LTBP4	Latent transforming growth factor beta-binding protein 4	1.4	TGF-beta/BMP signalling pathway
MSX1	msh homeobox 1	2.4	TGF-beta/BMP signalling pathway
SMAD6	SMAD family member 6	2.1	TGF-beta/BMP signalling pathway
SP1	Sp1 transcription factor	1.3	TGF-beta/BMP signalling pathway
TGFBR2	transforming growth factor, beta-receptor II (70/80 kDa)	1.4	TGF-beta/BMP signalling pathway
TGFBR3	Transforming growth factor, beta receptor III	1.7	TGF-beta/BMP signalling pathway
TGFBRAP1	Transforming growth factor, beta receptor associated protein 1	1.2	TGF-beta/BMP signalling pathway
THBS2	Thrombospondin 2	2	TGF-beta/BMP signalling pathway
THBS3	Thrombospondin 3	2	TGF-beta/BMP signalling pathway
TWSG1	Twisted gastrulation homolog 1 (Drosophila)	1.4	TGF-beta/BMP signalling pathway
ZFYVE9	Zinc finger, FYVE domain containing 9	1.1	TGF-beta/BMP signalling pathway
FRZB	Frizzled-related protein	2.1	Wnt signalling pathway
FZD3	Frizzled homolog 3 (Drosophila)	1.8	Wnt signalling pathway
FZD8	Frizzled homolog 8 (Drosophila)	2.8	Wnt signalling pathway
RYK	RYK receptor-like tyrosine kinase	1.4	Wnt signalling pathway
APH1B	Anterior pharynx defective 1 homolog B (Caenorhabditis elegans)	-1.5	Notch signaling pathway
CFD	Complement factor D (adipsin)	4.4	Notch signaling pathway
DTX2	Deltex homolog 2 (Drosophila)	-1.6	Notch signaling pathway
FOXC1	Forkhead box C1	1.7	Notch signaling pathway
HEY1	Hairy/enhancer-of-split related with YRPW motif 1	2.2	Notch signaling pathway
MIB1	Mindbomb homolog 1 (Drosophila)	1.4	Notch signaling pathway
NOTCH2	Notch homolog 2 (Drosophila)	1.4	Notch signaling pathway
NRG1	Neuregulin 1	-1.8	Notch signaling pathway
POFUT1	Protein O-fucosyltransferase 1	1.3	Notch signaling pathway
PSEN2	Presenilin 2 (Alzheimer disease 4)	1.3	Notch signaling pathway
PSENEN	Presenilin enhancer 2 homolog (C. elegans)	-1.5	Notch signaling pathway
TP63	Tumor protein p63	-1.4	Notch signaling pathway
WDR12	WD repeat domain 12	-1.5	Notch signaling pathway
