Gene symbol	Gene name	Function	Expression
Acat1	Acetyl-coenzyme A acetyltransferase 1	Energy metabolism	Decreased genes uponSNF5말nactivation
Car5a	Carbonic anhydrase 5a, mitochondrial	Energy metabolism	Decreased genes uponSNF5말nactivation
Car8	Carbonic anhydrase 8	Energy metabolism	Decreased genes uponSNF5말nactivation
Fabp4	Fatty acid-binding protein 4, adipocyte	Energy metabolism	Decreased genes uponSNF5말nactivation
Facl2	Fatty acid coenzyme A ligase, long chain 2	Energy metabolism	Decreased genes uponSNF5말nactivation
Fbp1	Fructose bisphosphatase 1	Energy metabolism	Decreased genes uponSNF5말nactivation
G6pc	Glucose-6-phosphatase, catalytic	Energy metabolism	Decreased genes uponSNF5말nactivation
G6pt1	Glucose-6-phosphatase, transport protein 1	Energy metabolism	Decreased genes uponSNF5말nactivation
Pck1	Phosphoenolpyruvate carboxykinase 1, cytosolic	Energy metabolism	Decreased genes uponSNF5말nactivation
Pcx	Pyruvate carboxylase	Energy metabolism	Decreased genes uponSNF5말nactivation
Pfkfb1	6-Phosphofructo-2-kinase/fructose-2,6-biphosphatase 1	Energy metabolism	Decreased genes uponSNF5말nactivation
Ppp1r3c	Protein phosphatase 1, regulatory (inhibitor) subunit 3C	Energy metabolism	Decreased genes uponSNF5말nactivation
Abcd2	ATP-binding cassette, subfamily D (ALD), member 2	Energy metabolism	Genes not changed uponSNF5말nactivation
Fabp1	Fatty acid-binding protein 1, liver	Energy metabolism	Genes not changed uponSNF5말nactivation
Gyk	Glycerol kinase	Energy metabolism	Genes not changed uponSNF5말nactivation
Hao1	Hydroxyacid oxidase 1, liver	Energy metabolism	Genes not changed uponSNF5말nactivation
Itih4	Inter-alpha-trypsin inhibitor, heavy chain 4	Energy metabolism	Genes not changed uponSNF5말nactivation
Lcat	Lecithin cholesterol acyltransferase	Energy metabolism	Genes not changed uponSNF5말nactivation
A2m	Alpha-2-macroglobulin	Serum proteins	Genes not changed uponSNF5말nactivation
Apoa5	Apolipoprotein A-V	Serum proteins	Decreased genes uponSNF5말nactivation
Apoc4	Apolipoprotein C-IV	Serum proteins	Decreased genes uponSNF5말nactivation
C4	Complement component 4 (within H-2S)	Serum proteins	Decreased genes uponSNF5말nactivation
Crp	C-reactive protein, petaxin related	Serum proteins	Decreased genes uponSNF5말nactivation
F10	Coagulation factor X	Serum proteins	Decreased genes uponSNF5말nactivation
F11	Coagulation factor XI	Serum proteins	Decreased genes uponSNF5말nactivation
Hp	Haptoglobin	Serum proteins	Decreased genes uponSNF5말nactivation
Igfbp2	Insulin-like growth factor-binding protein 2	Serum proteins	Decreased genes uponSNF5말nactivation
Mup1	Major urinary protein 1	Serum proteins	Decreased genes uponSNF5말nactivation
Afp	Alpha fetoprotein	Serum proteins	Genes not changed uponSNF5말nactivation
C4bp	Complement component 4-binding protein	Serum proteins	Genes not changed uponSNF5말nactivation
Cfh	Complement component factor h	Serum proteins	Genes not changed uponSNF5말nactivation
Cfhl1	Complement component factor h-like 1	Serum proteins	Genes not changed uponSNF5말nactivation
Cfi	Complement component factor i	Serum proteins	Genes not changed uponSNF5말nactivation
Cpb2	Carboxypeptidase B2 (plasma)	Serum proteins	Genes not changed uponSNF5말nactivation
F13b	Coagulation factor XIII, beta subunit	Serum proteins	Genes not changed uponSNF5말nactivation
Ttr	Transthyretin	Serum proteins	Genes not changed uponSNF5말nactivation
Defb1	Defensin beta 1	Antimicrobial peptides	Decreased genes uponSNF5말nactivation
Lbp	Lipopolysaccharide-binding protein	Antimicrobial peptides	Decreased genes uponSNF5말nactivation
Pglyrp	Peptidoglycan recognition protein	Antimicrobial peptides	Decreased genes uponSNF5말nactivation
Camp	Cathelicidin antimicrobial peptide	Antimicrobial peptides	Genes not changed uponSNF5말nactivation
S100a1	S100 calcium-binding protein A1	Calcium regulation	Decreased genes uponSNF5말nactivation
Rgn	Regucalcin	Calcium regulation	Genes not changed uponSNF5말nactivation
S100a8	S100 calcium-binding protein A8 (calgranulin A)	Calcium regulation	Genes not changed uponSNF5말nactivation
S100a9	S100 calcium-binding protein A9 (calgranulin B)	Calcium regulation	Genes not changed uponSNF5말nactivation
Cldn1	Claudin 1	Cell됶ell interactions	Genes not changed uponSNF5말nactivation
Cyp2c37	Cytochrome P450, family 2. subfamily c, polypeptide 37	Cytochrome P450	Decreased genes uponSNF5말nactivation
Cyp2c38	Cytochrome P450, family 2. subfamily c, polypeptide 38	Cytochrome P450	Decreased genes uponSNF5말nactivation
Cyp2c70	Cytochrome P450, family 2, subfamily c, polypeptide 70	Cytochrome P450	Decreased genes uponSNF5말nactivation
Cyp2d9	Cytochrome P450, family 2, subfamily d, polypeptide 9	Cytochrome P450	Decreased genes uponSNF5말nactivation
Cyp2d10	Cytochrome P450, family 2, subfamily d, polypeptide 10	Cytochrome P450	Decreased genes uponSNF5말nactivation
Cyp2d26	Cytochrome P450, family 2, subfamily d, polypeptide 26	Cytochrome P450	Decreased genes uponSNF5말nactivation
Cyp2e1	Cytochrome P450, family 2, subfamily e, polypeptide 1	Cytochrome P450	Decreased genes uponSNF5말nactivation
Cyp3a13	Cytochrome P450, family 3, subfamily a, polypeptide 13	Cytochrome P450	Decreased genes uponSNF5말nactivation
Cyp3a25	Cytochrome P450, family 3, subfamily a, polypeptide 25	Cytochrome P450	Decreased genes uponSNF5말nactivation
Cyp4a10	Cytochrome P450, family 4, subfamily a, polypeptide 10	Cytochrome P450	Decreased genes uponSNF5말nactivation
Cyp4a14	Cytochrome P450, family 4, subfamily a, polypeptide 14	Cytochrome P450	Decreased genes uponSNF5말nactivation
Cyp4f15	Cytochrome P450, family 4, subfamily f, polypeptide 15	Cytochrome P450	Decreased genes uponSNF5말nactivation
Cyp8b1	Cytochrome P450, family 8, subfamily b, polypeptide 1	Cytochrome P450	Decreased genes uponSNF5말nactivation
Cyp39a1	Cytochrome P450, family 39, subfamily a, polypeptide 1	Cytochrome P450	Decreased genes uponSNF5말nactivation
Cyp2f2	Cytochrome P450, family 2, subfamily f, polypeptide 2	Cytochrome P450	Genes not changed uponSNF5말nactivation
Cyp3a11	Cytochrome P450, family 3, subfamily a, polypeptide 11	Cytochrome P450	Genes not changed uponSNF5말nactivation
Cyp3a16	Cytochrome P450, family 3, subfamily a, polypeptide 16	Cytochrome P450	Genes not changed uponSNF5말nactivation
