Gene Symbol	Description	
ALPK3	alpha-kinase 3	
BMP2	bone morphogenetic protein 2	
CASQ2	calsequestrin 2 (cardiac muscle)	
CENTA2	centaurin, alpha 2	
FBN1	fibrillin 1	
FGF12	fibroblast growth factor 12	
GATA4	GATA binding protein 4	
GATA5	GATA binding protein 5	
GATA6	GATA binding protein 6	
IRX4	iroquois homeobox protein 4	
JUN	jun oncogene	
KLF2	Kruppel-like factor 2 (lung)	
MEF2A	MADS box transcription enhancer factor 2, polypeptide A (myocyte enhancer factor 2A)	
MEF2C	MADS box transcription enhancer factor 2, polypeptide C (myocyte enhancer factor 2C)	
MEF2D	MADS box transcription enhancer factor 2, polypeptide D (myocyte enhancer factor 2D)	
MYOCD	myocardin	
NKX2-5	NK2 transcription factor related, locus 5 (Drosophila)	
NR4A1	nuclear receptor subfamily 4, group A, member 1	
OSR1	odd-skipped related 1 (Drosophila)	
PDLIM5	PDZ and LIM domain 5	
PPARGC1A	peroxisome proliferative activated receptor, gamma, coactivator 1, alpha	
SHOX2	short stature homeobox 2	
SRI	sorcin	
TBX5	T-box 5	
TGFB2	transforming growth factor, beta 2	
